%%%%%%%%%%%%%%%%%%%%%%%%%
%.. P  ....      ....   %
%..  ...  ...  ...  ... %
%..  ...  ...  ...  ... %
%..  ...  ...  ...  ...G%
%..  ...  ...  ...  ... %
%..  ...  ...  ...  ... %
%..    ....      ....  o%
%%%%%%%%%%%%%%%%%%%%%%%%%
